F 200,22,0
C 1, 22, 0

        1111111111111111111111111
        1000000000110000000000001
        1011000001110000000000001
        1001000000000000000000001
111111111011000001110000000000001
100000000011000001110111111111111
11110111111111011100000010001
11110111111111011101010010001
11000000110101011110000010001
10000000000000001 100000010001
10000000000000001111010010001
11000001110101011111011110N0111
11110111 1110101 101111010001
11111111 1111111 111111111111

NO ./path_to_the_north_texture.xpm
EA ./path_to_the_east_texture.xpm
SO ./path_to_the_south_texture.xpm
WE ./path_to_the_west_texture.xpm
